а	a
б	b
в	v
г	g
д	d
е	e
ё	ë
ж	ž
з	z
и	i
й	j
к	k
л	l
м	m
н	n
о	o
п	p
р	r
с	s
т	t
у	u
ф	f
х	x
ц	c
ч	č
ш	š
щ	šč
ъ	"
ы	y
ь	'
э	è
ю	ju
я	ja
А	A
Б	B
В	V
Г	G
Д	D
Е	E
Ё	Ë
Ж	Ž
З	Z
И	I
Й	J
К	K
Л	L
М	M
Н	N
О	O
П	P
Р	R
С	S
Т	T
У	U
Ф	F
Х	X
Ц	C
Ч	Č
Ш	Š
Щ	Šč
Ъ	"
Ы	Y
Ь	'
Э	È
Ю	Ju
Я	Ja
І	Ï
і	ï
Ў	W
ў	w
Ґ	G'
ґ	g'
Ї	Ji
ї	ji
Ђ	Đ
ђ	đ
Љ	Lj
љ	lj
Њ	Nj
њ	nj
Ћ	Ć
ћ	ć
Ј	J
ј	j
Џ	Dž
џ	dž
